c88888888bbb8888888c1
911111111111111111171
911111111111111111171
9111aaaaa11aaaaa11171
9111a1111111111a11171
9111a1111111111a11171
9111a1111111111a11171
9111a1111111111a11171
9111a1111111111a11171
9111a1111111111a11171
9111a1111111111a11171
9111a1111111111a11171
9111a1111111111a11171
9111a1111111111a11171
9111a1111111111a11171
9111a1111111111a11171
9111aaaaa11aaaaa11171
911111111111111111171
911111111111111111171
c00000000bbb0000000c1
