c8888888cb11c888888c1
911111111sss111111171
91aaaaaaaa11aaaaaa171
91a111a1a111a1a11a171
91a1a1a1a1a11111aa171
91a1a1111111aaa11a171
91a1a1a1aaa111aaaa171
91a1aawewwa1aa1a1a171
91a111weewa111111a171
91a1aaweewa1a11aaa171
91a1a1wwewa11a111a171
91a1a1aa11aa1a1a1a171
91a1a1111a1a1aaa1a171
91a1aaa11a11111aaa171
91a111a1aa1aaa111a171
91aaa1a11a1a1a1a1a171
91a111a1a11a111a1a171
91aaaaaaaa11aaaaaa171
911111111fff111111171
c0000000cb11c000000c1
