c00000000bbb0000000c1
011111111111111111101
011111111111111111101
0111aaaaa11aaaaa11101
0111a1111111111a11101
0111a1111111111a11101
0111a1111111111a11101
0111a1111111111a11101
0111a1111111111a11101
0111a1111111111a11101
0111a1111111111a11101
0111a1111111111a11101
0111a1111111111a11101
0111a1111111111a11101
0111a1111111111a11101
0111a1111111111a11101
0111aaaaa11aaaaa11101
011111111111111111101
011111111111111111101
c00000000bbb0000000c1
